111111111111111111111111111111111111111111111111
1LLLLLLLLLLLLLLLLLLLLLLLLLLLLLLLLLLLLLLLLLLLLLL1
1LLLLLLLLLLLLLLLLLLLLLLLLLLLLLLLLLLLLLLLLLLLLLL1
1LLLLLLLLLLLLLLLLLLLLLLLLLLLLLLLLLLLLLLLLLLLLLL1
1LLLLLLLLLLLLLLLLLLLLLLLLLLLLLLLLLLLLLLLLLLLLLL1
1LLLLLLLLLLLLLLLLLL444444444444LLLLLLLLLLLLLLLL1
1LLLLLLLLLLLLLLLLLL444444444444LLLLLLLLLLLLLLLL1
1LLLLLLLLLLLLLLLLLL444449444444LLLLLLLLLLLLLLLL1
1LLLLLLLLLLLLLLLLLL444444444444LLLLLLLLLLLLLLLL1
1LLLLLLLLLLLLLLLLLL444444444444LLLLLLLLLLLLLLLL1
1LLLLLLLLLLLLLLLLLLLLL444444LLLLLLLLLLLLLLLLLL1
1LLLLLLLLLLLLLLLLLLLLL000000LLLLLLLLLLLLLLLLLL1
1LLLLLLLLLLLLLLLLLLLLL000000LLLLLLLLLLLLLLLLLL1
1LLLLLLLLLLLLLLLLLLLLL000000LLLLLLLLLLLLLLLLLL1
1LLLLLLLLLLLLLLLLLLLLL000000LLLLLLLLLLLLLLLLLL1
1LLLLLLLLLLLLLLLLLLLLL000000LLLLLLLLLLLLLLLLLL1
1LLLLLLLLLLLLLLLLLLLLL000000LLLLLLLLLLLLLLLLLL1
1LLLLLLLLLLLLLLLLLLLLL000000LLLLLLLLLLLLLLLLLL1
1LLLLLLLLLLLLLLLLLLLLL000000LLLLLLLLLLLLLLLLLL1
222222222222222222222200000022222222222222222222
2BBBBBBBB333333333333333333333333BBBBBBBBBBBBB2
2BBBBBBBB333333333333333333333333BBBBBBBBBBBBB2
2BBBBBBBB333333333333333333333333BBBBBBBBBBBBB2
2BBBBBBBB333333333333333333333333BBBBBBBBBBBBB2
2BBBBBBBB333333333333333333333333BBBBBBBBBBBBB2
2BBBBBBBB333333333333333333333333BBBBBBBBBBBBB2
2BBBBBBBB333333333333333333333333BBBBBBBBBBBBB2
2BBBBBBBB333333333333333333333333BBBBBBBBBBBBB2
2BBBBBBBB333333333333333333333333BBBBBBBBBBBBB2
2BBBBBBBB333333333333333333333333BBBBBBBBBBBBB2
2BBBBBBBB333333333333333333333333BBBBBBBBBBBBB2
2BBBBBBBB333333333333333333333333BBBBBBBBBBBBB2
2BBBBBBBB333333333333333333333333BBBBBBBBBBBBB2
2BBBBBBBB333333333333333333333333BBBBBBBBBBBBB2
2BBBBBBBB333333333333333333333333BBBBBBBBBBBBB2
22222222222222222222255522222222222222222222222
2555555555522222555555555555222225555555555555552
25222222252555252222222222525552522222222222552
25255555252555252555555552525552525555555552552
25252555252522252522222252522252525222222252552
25252522252555552525225252555552525255225252552
25252522522222252525252522222252525252552252552
25255525555555252525252555555252525252555252552
25255255555555252525255255555252525255252252552
25552525555555255525255555555255525252552555552
22225255255555522225225555552522225255222255552
25555255255555555525255555555555525255555555552
25222255252522222225252522222222525252555552552
25252222252522222525222522222222525252552225552
25252222255555555555552555555555555555255222552
25252555555555555555555555555555555555555555552
2222222222222222222222222222222222222222222222222
